-- GnuMed ISO 3166-1 country codes
-- GPL

-- $Source: /home/ncq/Projekte/cvs2git/vcs-mirror/gnumed/gnumed/server/sql/Attic/iso-country-codes.txt,v $
-- $Revision: 1.1 $

-- Here come the ISO country codes ...
AF	AFGHANISTAN	\N
AL	ALBANIA	\N
DZ	ALGERIA	\N
AS	AMERICAN SAMOA	\N
AD	ANDORRA	\N
AO	ANGOLA	\N
AI	ANGUILLA	\N
AQ	ANTARCTICA	\N
AG	ANTIGUA AND BARBUDA	\N
AR	ARGENTINA	\N
AM	ARMENIA	\N
AW	ARUBA	\N
AU	AUSTRALIA	\N
AT	AUSTRIA	\N
AZ	AZERBAIJAN	\N
BS	BAHAMAS	\N
BH	BAHRAIN	\N
BD	BANGLADESH	\N
BB	BARBADOS	\N
BY	BELARUS	\N
BE	BELGIUM	\N
BZ	BELIZE	\N
BJ	BENIN	\N
BM	BERMUDA	\N
BT	BHUTAN	\N
BO	BOLIVIA	\N
BA	BOSNIA AND HERZEGOVINA	\N
BW	BOTSWANA	\N
BV	BOUVET ISLAND	\N
BR	BRAZIL	\N
IO	BRITISH INDIAN OCEAN TERRITORY	\N
BN	BRUNEI DARUSSALAM	\N
BG	BULGARIA	\N
BF	BURKINA FASO	\N
BI	BURUNDI	\N
KH	CAMBODIA	\N
CM	CAMEROON	\N
CA	CANADA	\N
CV	CAPE VERDE	\N
KY	CAYMAN ISLANDS	\N
CF	CENTRAL AFRICAN REPUBLIC	\N
TD	CHAD	\N
CL	CHILE	\N
CN	CHINA	\N
CX	CHRISTMAS ISLAND	\N
CC	COCOS (KEELING) ISLANDS	\N
CO	COLOMBIA	\N
KM	COMOROS	\N
CG	CONGO	\N
CD	CONGO, THE DEMOCRATIC REPUBLIC	\N
CK	COOK ISLANDS	\N
CR	COSTA RICA	\N
CI	COTE D'IVOIRE	\N
HR	CROATIA	\N
CU	CUBA	\N
CY	CYPRUS	\N
CZ	CZECH REPUBLIC	\N
DK	DENMARK	\N
DJ	DJIBOUTI	\N
DM	DOMINICA	\N
DO	DOMINICAN REPUBLIC	\N
TP	EAST TIMOR	\N
EC	ECUADOR	\N
EG	EGYPT	\N
SV	EL SALVADOR	\N
GQ	EQUATORIAL GUINEA	\N
ER	ERITREA	\N
EE	ESTONIA	\N
ET	ETHIOPIA	\N
FK	FALKLAND ISLANDS (MALVINAS)	\N
FO	FAROE ISLANDS	\N
FJ	FIJI	\N
FI	FINLAND	\N
FR	FRANCE	\N
GF	FRENCH GUIANA	\N
PF	FRENCH POLYNESIA	\N
TF	FRENCH SOUTHERN TERRITORIES	\N
GA	GABON	\N
GM	GAMBIA	\N
GE	GEORGIA	\N
DE	GERMANY	\N
GH	GHANA	\N
GI	GIBRALTAR	\N
GR	GREECE	\N
GL	GREENLAND	\N
GD	GRENADA	\N
GP	GUADELOUPE	\N
GU	GUAM	\N
GT	GUATEMALA	\N
GN	GUINEA	\N
GW	GUINEA-BISSAU	\N
GY	GUYANA	\N
HT	HAITI	\N
HM	HEARD ISLAND AND MCDONALD ISLA	\N
VA	HOLY SEE (VATICAN CITY STATE)	\N
HN	HONDURAS	\N
HK	HONG KONG	\N
HU	HUNGARY	\N
IS	ICELAND	\N
IN	INDIA	\N
ID	INDONESIA	\N
IR	IRAN, ISLAMIC REPUBLIC OF	\N
IQ	IRAQ	\N
IE	IRELAND	\N
IL	ISRAEL	\N
IT	ITALY	\N
JM	JAMAICA	\N
JP	JAPAN	\N
JO	JORDAN	\N
KZ	KAZAKSTAN	\N
KE	KENYA	\N
KI	KIRIBATI	\N
KP	KOREA, DEMOCRATIC PEOPLE'S REP	\N
KR	KOREA, REPUBLIC OF	\N
KW	KUWAIT	\N
KG	KYRGYZSTAN	\N
LA	LAO PEOPLE'S DEMOCRATIC REPUBL	\N
LV	LATVIA	\N
LB	LEBANON	\N
LS	LESOTHO	\N
LR	LIBERIA	\N
LY	LIBYAN ARAB JAMAHIRIYA	\N
LI	LIECHTENSTEIN	\N
LT	LITHUANIA	\N
LU	LUXEMBOURG	\N
MO	MACAU	\N
MK	MACEDONIA, THE FORMER YUGOSLAV	\N
MG	MADAGASCAR	\N
MW	MALAWI	\N
MY	MALAYSIA	\N
MV	MALDIVES	\N
ML	MALI	\N
MT	MALTA	\N
MH	MARSHALL ISLANDS	\N
MQ	MARTINIQUE	\N
MR	MAURITANIA	\N
MU	MAURITIUS	\N
YT	MAYOTTE	\N
MX	MEXICO	\N
FM	MICRONESIA, FEDERATED STATES O	\N
MD	MOLDOVA, REPUBLIC OF	\N
MC	MONACO	\N
MN	MONGOLIA	\N
MS	MONTSERRAT	\N
MA	MOROCCO	\N
MZ	MOZAMBIQUE	\N
MM	MYANMAR	\N
NA	NAMIBIA	\N
NR	NAURU	\N
NP	NEPAL	\N
NL	NETHERLANDS	\N
AN	NETHERLANDS ANTILLES	\N
NC	NEW CALEDONIA	\N
NZ	NEW ZEALAND	\N
NI	NICARAGUA	\N
NE	NIGER	\N
NG	NIGERIA	\N
NU	NIUE	\N
NF	NORFOLK ISLAND	\N
MP	NORTHERN MARIANA ISLANDS	\N
NO	NORWAY	\N
OM	OMAN	\N
PK	PAKISTAN	\N
PW	PALAU	\N
PS	PALESTINIAN TERRITORY, OCCUPIE	\N
PA	PANAMA	\N
PG	PAPUA NEW GUINEA	\N
PY	PARAGUAY	\N
PE	PERU	\N
PH	PHILIPPINES	\N
PN	PITCAIRN	\N
PL	POLAND	\N
PT	PORTUGAL	\N
PR	PUERTO RICO	\N
QA	QATAR	\N
RE	REUNION	\N
RO	ROMANIA	\N
RU	RUSSIAN FEDERATION	\N
RW	RWANDA	\N
SH	SAINT HELENA	\N
KN	SAINT KITTS AND NEVIS	\N
LC	SAINT LUCIA	\N
PM	SAINT PIERRE AND MIQUELON	\N
VC	SAINT VINCENT AND THE GRENADIN	\N
WS	SAMOA	\N
SM	SAN MARINO	\N
ST	SAO TOME AND PRINCIPE	\N
SA	SAUDI ARABIA	\N
SN	SENEGAL	\N
SC	SEYCHELLES	\N
SL	SIERRA LEONE	\N
SG	SINGAPORE	\N
SK	SLOVAKIA	\N
SI	SLOVENIA	\N
SB	SOLOMON ISLANDS	\N
SO	SOMALIA	\N
ZA	SOUTH AFRICA	\N
GS	SOUTH GEORGIA AND THE SOUTH SA	\N
ES	SPAIN	\N
LK	SRI LANKA	\N
SD	SUDAN	\N
SR	SURINAME	\N
SJ	SVALBARD AND JAN MAYEN	\N
SZ	SWAZILAND	\N
SE	SWEDEN	\N
CH	SWITZERLAND	\N
SY	SYRIAN ARAB REPUBLIC	\N
TW	TAIWAN, PROVINCE OF CHINA	\N
TJ	TAJIKISTAN	\N
TZ	TANZANIA, UNITED REPUBLIC OF	\N
TH	THAILAND	\N
TG	TOGO	\N
TK	TOKELAU	\N
TO	TONGA	\N
TT	TRINIDAD AND TOBAGO	\N
TN	TUNISIA	\N
TR	TURKEY	\N
TM	TURKMENISTAN	\N
TC	TURKS AND CAICOS ISLANDS	\N
TV	TUVALU	\N
UG	UGANDA	\N
UA	UKRAINE	\N
AE	UNITED ARAB EMIRATES	\N
GB	UNITED KINGDOM	\N
US	UNITED STATES	\N
\.
